11111111111111111111111111
10101P00101110110000010001
1010101010010011111P110101
10001000101010111101110P01
101P1010101110111011110101
101010101011101100P0010101
11111111111111111111111111