1111111111111111111111
1001111000P00000000001
101100100000P010000001
10000000P0000010011111
101100001000P010010001
101100000000P010010001
1111111111111111111111
