1111111111111111111111
11111WW111111111111111
1000000000E0h000000001
1000000000000000000011
1111111111111111111111