111111111111111111111111
11000100P00000C0000E0001
100101111011010011111101
10C10111101101C111111101
101000001001010010001001
101001011101011111111111
10010100C1010110C1010001
100111111101000000010101
10C001000101111111110001
101111010100010000011101
10000001000000001C000001
111111111111111111111111
