1111111111
1111111011
1000ECP001
1111111111
