1111
1011
1001
1001
1011
1111
