111111111111111111111111111111
100001100000000000000000P11111
100100000000000001111111010001
110011111111l11100000111010101
111011111111111111110111000101
111000000000000000000111111101
111111111111111111111111111111
