111111111111
111PCC101111
10E0000001C1
111111111111
111111111111
