111111111111
100000000001
10000C000001
100000000001
1E00C0000001
100000000001
1C0000000001
100000000001
1P0000000001
111111111111
