111111111111
100000000001
10000C000001
100000000001
1E0000000001
100000000001
100000000001
1000P0000001
100000000001
111111111111
