111111111111
1110C01P1111
100000000111
111111E000C1
111111111111