11111111111111111111111111
10001P00101110110000000001
1010001000010011111P110101
10001000101010000101110P01
101P1010101000110011110101
101010001000101100P0010101
11111111111111111111111111
