111111111111111111111111
11000100P0C00000000C0001
1C0101111011000011111101
10010111101100C011111101
101000001001010010001001
101001011101011111111111
10C101000101011001010001
100111111101000000010101
1C0C01000101111111110001
1011110101000000C0011101
10000C010000000C00000E01
111111111111111111111111
