111111111111111111111111111111111111111111111111
1000C000000011110000000P00000000000C00000C000111
101111111110000001111011111111CC1110111111110111
101111100110111111100011110011111110111111110C11
101111000110110001101011111111110000C00000111011
101110000110111111101111101111011111111110111001
100000C000000000C000000001111E0000000000C0000C11
111111111111111111111111111111111111111111111111
