0111111
1100p11
1000001
111C0E1
1111111
