111111111
1E0101C01
1100C0P11
101011011
111111111
