1111111111111
100C00P000C11
1000C0000EC11
1111111111111
