111111
100001
1PCE01
100011
111111
